mean_fit_time,std_fit_time,mean_score_time,std_score_time,param_clf,param_clf__max_depth,param_clf__n_estimators,param_clf__random_state,param_clf__max_iter,param_clf__learning_rate,params,split0_test_accuracy,split1_test_accuracy,split2_test_accuracy,split3_test_accuracy,split4_test_accuracy,mean_test_accuracy,std_test_accuracy,rank_test_accuracy,split0_test_balanced_accuracy,split1_test_balanced_accuracy,split2_test_balanced_accuracy,split3_test_balanced_accuracy,split4_test_balanced_accuracy,mean_test_balanced_accuracy,std_test_balanced_accuracy,rank_test_balanced_accuracy,split0_test_roc_auc,split1_test_roc_auc,split2_test_roc_auc,split3_test_roc_auc,split4_test_roc_auc,mean_test_roc_auc,std_test_roc_auc,rank_test_roc_auc,split0_test_f1,split1_test_f1,split2_test_f1,split3_test_f1,split4_test_f1,mean_test_f1,std_test_f1,rank_test_f1,split0_test_recall,split1_test_recall,split2_test_recall,split3_test_recall,split4_test_recall,mean_test_recall,std_test_recall,rank_test_recall,split0_test_sensitivity,split1_test_sensitivity,split2_test_sensitivity,split3_test_sensitivity,split4_test_sensitivity,mean_test_sensitivity,std_test_sensitivity,rank_test_sensitivity,split0_test_specificity,split1_test_specificity,split2_test_specificity,split3_test_specificity,split4_test_specificity,mean_test_specificity,std_test_specificity,rank_test_specificity,split0_test_precision,split1_test_precision,split2_test_precision,split3_test_precision,split4_test_precision,mean_test_precision,std_test_precision,rank_test_precision,split0_test_NPV,split1_test_NPV,split2_test_NPV,split3_test_NPV,split4_test_NPV,mean_test_NPV,std_test_NPV,rank_test_NPV,split0_test_PPV,split1_test_PPV,split2_test_PPV,split3_test_PPV,split4_test_PPV,mean_test_PPV,std_test_PPV,rank_test_PPV,cv,Title,RunType,MainDataset,date
0.01168212890625,0.002380294960971637,0.014036464691162109,0.0031357234459772087,RandomForestClassifier(),3,10,42,,,"{'clf': RandomForestClassifier(), 'clf__max_depth': 3, 'clf__n_estimators': 10, 'clf__random_state': 42}",0.6879432624113475,0.7071428571428572,0.6714285714285714,0.7714285714285715,0.7428571428571429,0.7161600810536981,0.03645749928876299,5,0.572875816993464,0.5980392156862745,0.5532055518836748,0.6799999999999999,0.6444444444444445,0.6097130058015716,0.0465464984437647,5,0.7234204793028324,0.7511566424322538,0.5794227803480942,0.7934444444444444,0.7352222222222222,0.7165333137499694,0.07253978719672069,5,0.26666666666666666,0.32786885245901637,0.20689655172413793,0.5294117647058824,0.45454545454545453,0.35707785802023156,0.1189795629968352,5,0.1568627450980392,0.19607843137254902,0.11764705882352941,0.36,0.3,0.22611764705882353,0.09038534277408633,5,0.1568627450980392,0.19607843137254902,0.11764705882352941,0.36,0.3,0.22611764705882353,0.09038534277408633,5,0.9888888888888889,1.0,0.9887640449438202,1.0,0.9888888888888889,0.9933083645443196,0.0054638876436619715,1,0.8888888888888888,1.0,0.8571428571428571,1.0,0.9375,0.9367063492063492,0.05767089582052416,1,0.6742424242424242,0.6846153846153846,0.6616541353383458,0.7377049180327869,0.717741935483871,0.6951917595425625,0.028253798587729854,5,0.8888888888888888,1.0,0.8571428571428571,1.0,0.9375,0.9367063492063492,0.05767089582052416,1,5,dfcmpltPreLC3_SITE7_Holdout,Holdout,dfcmpltPreLC3_SITE7,2024-05-03 23:11:28.527213
0.05922961235046387,0.0015870415124583967,0.010998106002807618,0.0021611015265802854,LogisticRegression(),,,,1000,,"{'clf': RandomForestClassifier(), 'clf__max_depth': 3, 'clf__n_estimators': 10, 'clf__random_state': 42}",0.7021276595744681,0.7714285714285715,0.6928571428571428,0.8,0.6642857142857143,0.7261398176291792,0.0510228341733434,4,0.6477124183006536,0.7030182859660719,0.6202908129543953,0.7511111111111111,0.61,0.6664265256664463,0.053241169285607216,2,0.7797385620915033,0.808768451200705,0.7085261070720423,0.8108888888888889,0.7093333333333334,0.7634510685172946,0.04585798746786867,3,0.5227272727272727,0.5897435897435898,0.45569620253164556,0.6744186046511628,0.47191011235955055,0.5428991564026442,0.08067523861956848,2,0.45098039215686275,0.45098039215686275,0.35294117647058826,0.58,0.42,0.45098039215686275,0.07378012160273222,2,0.45098039215686275,0.45098039215686275,0.35294117647058826,0.58,0.42,0.45098039215686275,0.07378012160273222,2,0.8444444444444444,0.9550561797752809,0.8876404494382022,0.9222222222222223,0.8,0.88187265917603,0.05499306485071745,4,0.6216216216216216,0.8518518518518519,0.6428571428571429,0.8055555555555556,0.5384615384615384,0.692069542069542,0.11780462663276955,4,0.7307692307692307,0.7522123893805309,0.7053571428571429,0.7980769230769231,0.7128712871287128,0.7398573946425081,0.033296460714885255,2,0.6216216216216216,0.8518518518518519,0.6428571428571429,0.8055555555555556,0.5384615384615384,0.692069542069542,0.11780462663276955,4,5,dfcmpltPreLC3_SITE7_Holdout,Holdout,dfcmpltPreLC3_SITE7,2024-05-03 23:11:28.527213
0.03498444557189941,0.008714056366875361,0.03388423919677734,0.006130763490260593,"XGBClassifier(base_score=None, booster=None, callbacks=None,
              colsample_bylevel=None, colsample_bynode=None,
              colsample_bytree=None, device='cpu', early_stopping_rounds=None,
              enable_categorical=False, eval_metric=None, feature_types=None,
              gamma=None, grow_policy=None, importance_type=None,
              interaction_constraints=None, learning_rate=None, max_bin=None,
              max_cat_threshold=None, max_cat_to_onehot=None,
              max_delta_step=None, max_depth=None, max_leaves=None,
              min_child_weight=None, missing=nan, monotone_constraints=None,
              multi_strategy=None, n_estimators=None, n_jobs=None,
              num_parallel_tree=None, random_state=None, ...)",3,10,42,,0.1,"{'clf': RandomForestClassifier(), 'clf__max_depth': 3, 'clf__n_estimators': 10, 'clf__random_state': 42}",0.7588652482269503,0.7285714285714285,0.7142857142857143,0.7571428571428571,0.75,0.74177304964539,0.017469363761474822,1,0.6709150326797386,0.6274509803921569,0.616215025335977,0.6733333333333333,0.65,0.6475828743482411,0.022814702946479904,4,0.7103485838779956,0.763824630975986,0.7417933465521039,0.7738888888888888,0.7634444444444445,0.7506599789478837,0.02271545121992336,4,0.5142857142857142,0.40625,0.3939393939393939,0.5277777777777778,0.46153846153846156,0.46075826950826954,0.05439361012061634,4,0.35294117647058826,0.2549019607843137,0.2549019607843137,0.38,0.3,0.30854901960784314,0.05080355453511633,4,0.35294117647058826,0.2549019607843137,0.2549019607843137,0.38,0.3,0.30854901960784314,0.05080355453511633,4,0.9888888888888889,1.0,0.9775280898876404,0.9666666666666667,1.0,0.9866167290886392,0.012992266498945868,2,0.9473684210526315,1.0,0.8666666666666667,0.8636363636363636,1.0,0.9355342902711324,0.06060324009217957,2,0.7295081967213115,0.7007874015748031,0.696,0.7372881355932204,0.72,0.716716746777867,0.016003191036948708,4,0.9473684210526315,1.0,0.8666666666666667,0.8636363636363636,1.0,0.9355342902711324,0.06060324009217957,2,5,dfcmpltPreLC3_SITE7_Holdout,Holdout,dfcmpltPreLC3_SITE7,2024-05-03 23:11:28.527213
0.03875102996826172,0.009088050269693775,0.03371176719665527,0.008131707826505265,"XGBClassifier(base_score=None, booster=None, callbacks=None,
              colsample_bylevel=None, colsample_bynode=None,
              colsample_bytree=None, device='cpu', early_stopping_rounds=None,
              enable_categorical=False, eval_metric=None, feature_types=None,
              gamma=None, grow_policy=None, importance_type=None,
              interaction_constraints=None, learning_rate=None, max_bin=None,
              max_cat_threshold=None, max_cat_to_onehot=None,
              max_delta_step=None, max_depth=None, max_leaves=None,
              min_child_weight=None, missing=nan, monotone_constraints=None,
              multi_strategy=None, n_estimators=None, n_jobs=None,
              num_parallel_tree=None, random_state=None, ...)",3,10,42,,0.2,"{'clf': RandomForestClassifier(), 'clf__max_depth': 3, 'clf__n_estimators': 10, 'clf__random_state': 42}",0.7659574468085106,0.7142857142857143,0.7071428571428572,0.7642857142857142,0.75,0.7403343465045593,0.02491522567342731,2,0.6892156862745098,0.6245869134170522,0.6105970478078873,0.6877777777777778,0.6677777777777778,0.655991040611001,0.03255774777111279,3,0.7546840958605665,0.7752808988764045,0.73694646397885,0.7927777777777778,0.7848888888888889,0.7689156250764976,0.020443228140479615,1,0.56,0.42857142857142855,0.3880597014925373,0.56,0.5205479452054794,0.49143581505388906,0.07055233940767354,3,0.4117647058823529,0.29411764705882354,0.2549019607843137,0.42,0.38,0.35215686274509805,0.06596679928742644,3,0.4117647058823529,0.29411764705882354,0.2549019607843137,0.42,0.38,0.35215686274509805,0.06596679928742644,3,0.9666666666666667,0.9550561797752809,0.9662921348314607,0.9555555555555556,0.9555555555555556,0.9598252184769039,0.005437466202773007,3,0.875,0.7894736842105263,0.8125,0.84,0.8260869565217391,0.8286121281464531,0.02856330946974305,3,0.7435897435897436,0.7024793388429752,0.6935483870967742,0.7478260869565218,0.7350427350427351,0.72449725830575,0.022192727307502706,3,0.875,0.7894736842105263,0.8125,0.84,0.8260869565217391,0.8286121281464531,0.02856330946974305,3,5,dfcmpltPreLC3_SITE7_Holdout,Holdout,dfcmpltPreLC3_SITE7,2024-05-03 23:11:28.527213
0.03446087837219238,0.007064230368899411,0.03831024169921875,0.008432135788241361,"XGBClassifier(base_score=None, booster=None, callbacks=None,
              colsample_bylevel=None, colsample_bynode=None,
              colsample_bytree=None, device='cpu', early_stopping_rounds=None,
              enable_categorical=False, eval_metric=None, feature_types=None,
              gamma=None, grow_policy=None, importance_type=None,
              interaction_constraints=None, learning_rate=None, max_bin=None,
              max_cat_threshold=None, max_cat_to_onehot=None,
              max_delta_step=None, max_depth=None, max_leaves=None,
              min_child_weight=None, missing=nan, monotone_constraints=None,
              multi_strategy=None, n_estimators=None, n_jobs=None,
              num_parallel_tree=None, random_state=None, ...)",3,10,42,,1,"{'clf': RandomForestClassifier(), 'clf__max_depth': 3, 'clf__n_estimators': 10, 'clf__random_state': 42}",0.75177304964539,0.7357142857142858,0.7071428571428572,0.7857142857142857,0.7,0.7360688956433638,0.03114190711141439,3,0.707843137254902,0.6833002864066975,0.6566424322538004,0.74,0.66,0.6895571711830801,0.031225023774102637,1,0.8103485838779958,0.7311081736065212,0.7257105089226702,0.8074444444444445,0.7534444444444444,0.7656112310592152,0.03655682638440384,2,0.6153846153846154,0.5747126436781609,0.5393258426966292,0.6590909090909091,0.5531914893617021,0.5883411000424034,0.04372782319991214,1,0.5490196078431373,0.49019607843137253,0.47058823529411764,0.58,0.52,0.5219607843137255,0.039376923434831956,1,0.5490196078431373,0.49019607843137253,0.47058823529411764,0.58,0.52,0.5219607843137255,0.039376923434831956,1,0.8666666666666667,0.8764044943820225,0.8426966292134831,0.9,0.8,0.8571535580524344,0.03397777909795057,5,0.7,0.6944444444444444,0.631578947368421,0.7631578947368421,0.5909090909090909,0.6760180754917596,0.059542232472456894,5,0.7722772277227723,0.75,0.7352941176470589,0.7941176470588235,0.75,0.7603377984857309,0.020613365786012784,1,0.7,0.6944444444444444,0.631578947368421,0.7631578947368421,0.5909090909090909,0.6760180754917596,0.059542232472456894,5,5,dfcmpltPreLC3_SITE7_Holdout,Holdout,dfcmpltPreLC3_SITE7,2024-05-03 23:11:28.527213
0.0108584403991699,0.0016590247594497,0.0144505023956298,0.0035879359683893,RandomForestClassifier(),3.0,10.0,42.0,,,"{'clf': RandomForestClassifier(), 'clf__max_depth': 3, 'clf__n_estimators': 10, 'clf__random_state': 42}",0.6879432624113475,0.7071428571428572,0.6714285714285714,0.7714285714285715,0.7428571428571429,0.7161600810536981,0.0364574992887629,5,0.572875816993464,0.5980392156862745,0.5532055518836748,0.6799999999999999,0.6444444444444445,0.6097130058015716,0.0465464984437647,5,0.7234204793028324,0.7511566424322538,0.5794227803480942,0.7934444444444444,0.7352222222222222,0.7165333137499694,0.0725397871967206,5,0.2666666666666666,0.3278688524590163,0.2068965517241379,0.5294117647058824,0.4545454545454545,0.3570778580202315,0.1189795629968352,5,0.1568627450980392,0.196078431372549,0.1176470588235294,0.36,0.3,0.2261176470588235,0.0903853427740863,5,0.1568627450980392,0.196078431372549,0.1176470588235294,0.36,0.3,0.2261176470588235,0.0903853427740863,5,0.9888888888888888,1.0,0.9887640449438202,1.0,0.9888888888888888,0.9933083645443196,0.0054638876436619,1,0.8888888888888888,1.0,0.8571428571428571,1.0,0.9375,0.9367063492063492,0.0576708958205241,1,0.6742424242424242,0.6846153846153846,0.6616541353383458,0.7377049180327869,0.717741935483871,0.6951917595425625,0.0282537985877298,5,0.8888888888888888,1.0,0.8571428571428571,1.0,0.9375,0.9367063492063492,0.0576708958205241,1,5,dfcmpltPreLC3_SITE7_Holdout,Holdout,dfcmpltPreLC3_SITE7,2024-05-03 23:07:55.437204
0.052751874923706,0.0097796736894708,0.0112310886383056,0.0021386926938706,LogisticRegression(),,,,1000.0,,"{'clf': RandomForestClassifier(), 'clf__max_depth': 3, 'clf__n_estimators': 10, 'clf__random_state': 42}",0.7021276595744681,0.7714285714285715,0.6928571428571428,0.8,0.6642857142857143,0.7261398176291792,0.0510228341733434,4,0.6477124183006536,0.7030182859660719,0.6202908129543953,0.7511111111111111,0.61,0.6664265256664463,0.0532411692856072,2,0.7797385620915033,0.808768451200705,0.7085261070720423,0.8108888888888889,0.7093333333333334,0.7634510685172946,0.0458579874678686,3,0.5227272727272727,0.5897435897435898,0.4556962025316455,0.6744186046511628,0.4719101123595505,0.5428991564026442,0.0806752386195684,2,0.4509803921568627,0.4509803921568627,0.3529411764705882,0.58,0.42,0.4509803921568627,0.0737801216027322,2,0.4509803921568627,0.4509803921568627,0.3529411764705882,0.58,0.42,0.4509803921568627,0.0737801216027322,2,0.8444444444444444,0.9550561797752808,0.8876404494382022,0.9222222222222224,0.8,0.88187265917603,0.0549930648507174,4,0.6216216216216216,0.8518518518518519,0.6428571428571429,0.8055555555555556,0.5384615384615384,0.692069542069542,0.1178046266327695,4,0.7307692307692307,0.7522123893805309,0.7053571428571429,0.7980769230769231,0.7128712871287128,0.7398573946425081,0.0332964607148852,2,0.6216216216216216,0.8518518518518519,0.6428571428571429,0.8055555555555556,0.5384615384615384,0.692069542069542,0.1178046266327695,4,5,dfcmpltPreLC3_SITE7_Holdout,Holdout,dfcmpltPreLC3_SITE7,2024-05-03 23:07:55.437204
0.029850149154663,0.005995466319768,0.0287775516510009,0.0008206553598362,"XGBClassifier(base_score=None, booster=None, callbacks=None,
              colsample_bylevel=None, colsample_bynode=None,
              colsample_bytree=None, device='cpu', early_stopping_rounds=None,
              enable_categorical=False, eval_metric=None, feature_types=None,
              gamma=None, grow_policy=None, importance_type=None,
              interaction_constraints=None, learning_rate=None, max_bin=None,
              max_cat_threshold=None, max_cat_to_onehot=None,
              max_delta_step=None, max_depth=None, max_leaves=None,
              min_child_weight=None, missing=nan, monotone_constraints=None,
              multi_strategy=None, n_estimators=None, n_jobs=None,
              num_parallel_tree=None, random_state=None, ...)",3.0,10.0,42.0,,0.1,"{'clf': RandomForestClassifier(), 'clf__max_depth': 3, 'clf__n_estimators': 10, 'clf__random_state': 42}",0.7588652482269503,0.7285714285714285,0.7142857142857143,0.7571428571428571,0.75,0.74177304964539,0.0174693637614748,1,0.6709150326797386,0.6274509803921569,0.616215025335977,0.6733333333333333,0.65,0.6475828743482411,0.0228147029464799,4,0.7103485838779956,0.763824630975986,0.7417933465521039,0.7738888888888888,0.7634444444444445,0.7506599789478837,0.0227154512199233,4,0.5142857142857142,0.40625,0.3939393939393939,0.5277777777777778,0.4615384615384615,0.4607582695082695,0.0543936101206163,4,0.3529411764705882,0.2549019607843137,0.2549019607843137,0.38,0.3,0.3085490196078431,0.0508035545351163,4,0.3529411764705882,0.2549019607843137,0.2549019607843137,0.38,0.3,0.3085490196078431,0.0508035545351163,4,0.9888888888888888,1.0,0.9775280898876404,0.9666666666666668,1.0,0.9866167290886392,0.0129922664989458,2,0.9473684210526316,1.0,0.8666666666666667,0.8636363636363636,1.0,0.9355342902711324,0.0606032400921795,2,0.7295081967213115,0.7007874015748031,0.696,0.7372881355932204,0.72,0.716716746777867,0.0160031910369487,4,0.9473684210526316,1.0,0.8666666666666667,0.8636363636363636,1.0,0.9355342902711324,0.0606032400921795,2,5,dfcmpltPreLC3_SITE7_Holdout,Holdout,dfcmpltPreLC3_SITE7,2024-05-03 23:07:55.437204
0.0373387813568115,0.0086885655318341,0.0338181495666503,0.0083707879721039,"XGBClassifier(base_score=None, booster=None, callbacks=None,
              colsample_bylevel=None, colsample_bynode=None,
              colsample_bytree=None, device='cpu', early_stopping_rounds=None,
              enable_categorical=False, eval_metric=None, feature_types=None,
              gamma=None, grow_policy=None, importance_type=None,
              interaction_constraints=None, learning_rate=None, max_bin=None,
              max_cat_threshold=None, max_cat_to_onehot=None,
              max_delta_step=None, max_depth=None, max_leaves=None,
              min_child_weight=None, missing=nan, monotone_constraints=None,
              multi_strategy=None, n_estimators=None, n_jobs=None,
              num_parallel_tree=None, random_state=None, ...)",3.0,10.0,42.0,,0.2,"{'clf': RandomForestClassifier(), 'clf__max_depth': 3, 'clf__n_estimators': 10, 'clf__random_state': 42}",0.7659574468085106,0.7142857142857143,0.7071428571428572,0.7642857142857142,0.75,0.7403343465045593,0.0249152256734273,2,0.6892156862745098,0.6245869134170522,0.6105970478078873,0.6877777777777778,0.6677777777777778,0.655991040611001,0.0325577477711127,3,0.7546840958605665,0.7752808988764045,0.73694646397885,0.7927777777777778,0.7848888888888889,0.7689156250764976,0.0204432281404796,1,0.56,0.4285714285714285,0.3880597014925373,0.56,0.5205479452054794,0.491435815053889,0.0705523394076735,3,0.4117647058823529,0.2941176470588235,0.2549019607843137,0.42,0.38,0.352156862745098,0.0659667992874264,3,0.4117647058823529,0.2941176470588235,0.2549019607843137,0.42,0.38,0.352156862745098,0.0659667992874264,3,0.9666666666666668,0.9550561797752808,0.9662921348314608,0.9555555555555556,0.9555555555555556,0.959825218476904,0.005437466202773,3,0.875,0.7894736842105263,0.8125,0.84,0.8260869565217391,0.8286121281464531,0.028563309469743,3,0.7435897435897436,0.7024793388429752,0.6935483870967742,0.7478260869565218,0.7350427350427351,0.72449725830575,0.0221927273075027,3,0.875,0.7894736842105263,0.8125,0.84,0.8260869565217391,0.8286121281464531,0.028563309469743,3,5,dfcmpltPreLC3_SITE7_Holdout,Holdout,dfcmpltPreLC3_SITE7,2024-05-03 23:07:55.437204
