mean_fit_time,std_fit_time,mean_score_time,std_score_time,param_clf,param_clf__max_depth,param_clf__n_estimators,param_clf__random_state,param_clf__max_iter,param_clf__learning_rate,params,split0_test_accuracy,split1_test_accuracy,split2_test_accuracy,split3_test_accuracy,split4_test_accuracy,mean_test_accuracy,std_test_accuracy,rank_test_accuracy,split0_test_balanced_accuracy,split1_test_balanced_accuracy,split2_test_balanced_accuracy,split3_test_balanced_accuracy,split4_test_balanced_accuracy,mean_test_balanced_accuracy,std_test_balanced_accuracy,rank_test_balanced_accuracy,split0_test_roc_auc,split1_test_roc_auc,split2_test_roc_auc,split3_test_roc_auc,split4_test_roc_auc,mean_test_roc_auc,std_test_roc_auc,rank_test_roc_auc,split0_test_f1,split1_test_f1,split2_test_f1,split3_test_f1,split4_test_f1,mean_test_f1,std_test_f1,rank_test_f1,split0_test_recall,split1_test_recall,split2_test_recall,split3_test_recall,split4_test_recall,mean_test_recall,std_test_recall,rank_test_recall,split0_test_sensitivity,split1_test_sensitivity,split2_test_sensitivity,split3_test_sensitivity,split4_test_sensitivity,mean_test_sensitivity,std_test_sensitivity,rank_test_sensitivity,split0_test_specificity,split1_test_specificity,split2_test_specificity,split3_test_specificity,split4_test_specificity,mean_test_specificity,std_test_specificity,rank_test_specificity,split0_test_precision,split1_test_precision,split2_test_precision,split3_test_precision,split4_test_precision,mean_test_precision,std_test_precision,rank_test_precision,split0_test_NPV,split1_test_NPV,split2_test_NPV,split3_test_NPV,split4_test_NPV,mean_test_NPV,std_test_NPV,rank_test_NPV,split0_test_PPV,split1_test_PPV,split2_test_PPV,split3_test_PPV,split4_test_PPV,mean_test_PPV,std_test_PPV,rank_test_PPV,cv,Title,RunType,MainDataset,date
0.013060045242309571,0.0024920299375548734,0.015547895431518554,0.0029139406125664596,RandomForestClassifier(),3,10,42,,,"{'clf': RandomForestClassifier(), 'clf__max_depth': 3, 'clf__n_estimators': 10, 'clf__random_state': 42}",0.6363636363636364,0.6363636363636364,0.6181818181818182,0.6073059360730594,0.6255707762557078,0.6247571606475717,0.011116320390713863,5,0.5473484848484849,0.5492424242424242,0.5251922910725089,0.5057471264367817,0.5306948798328108,0.5316450412866021,0.01593429516657324,5,0.7663137052341598,0.7240444214876033,0.6626479993086163,0.7436868686868686,0.698493556252177,0.719037310193885,0.035970903890627334,5,0.1836734693877551,0.2,0.14285714285714285,0.022727272727272728,0.1276595744680851,0.13538349188805116,0.06215167434948646,5,0.10227272727272728,0.11363636363636363,0.08045977011494253,0.011494252873563218,0.06896551724137931,0.07536572622779518,0.035595239736583996,5,0.10227272727272728,0.11363636363636363,0.08045977011494253,0.011494252873563218,0.06896551724137931,0.07536572622779518,0.035595239736583996,5,0.9924242424242424,0.9848484848484849,0.9699248120300752,1.0,0.9924242424242424,0.987924356345409,0.010195721653153127,1,0.9,0.8333333333333334,0.6363636363636364,1.0,0.8571428571428571,0.8453679653679653,0.11904790240029246,1,0.6238095238095238,0.625,0.6172248803827751,0.6055045871559633,0.6179245283018868,0.6178927039300298,0.00692004123111139,5,0.9,0.8333333333333334,0.6363636363636364,1.0,0.8571428571428571,0.8453679653679653,0.11904790240029246,1,5,dfcmpltPreLC3_Holdout,Holdout,dfcmpltPreLC3,2024-05-03 23:11:16.815847
0.07773470878601074,0.018713777109301506,0.011266136169433593,0.0017717703520702247,LogisticRegression(),,,,1000,,"{'clf': RandomForestClassifier(), 'clf__max_depth': 3, 'clf__n_estimators': 10, 'clf__random_state': 42}",0.7318181818181818,0.7454545454545455,0.6772727272727272,0.7625570776255708,0.684931506849315,0.7204068078040681,0.0336252873457971,3,0.7121212121212122,0.7291666666666666,0.651585861204736,0.7364158829676071,0.6700626959247649,0.6998704637769974,0.03335812306607535,2,0.7635158402203857,0.7995867768595041,0.7172240947195576,0.7691570881226053,0.7307558342041102,0.7560479268252325,0.02922406950179902,3,0.6467065868263473,0.6705882352941176,0.5644171779141104,0.6708860759493671,0.6011560693641619,0.6307508290696209,0.04178144626513042,2,0.6136363636363636,0.6477272727272727,0.5287356321839081,0.6091954022988506,0.5977011494252874,0.5993991640543365,0.03906529972665871,1,0.6136363636363636,0.6477272727272727,0.5287356321839081,0.6091954022988506,0.5977011494252874,0.5993991640543365,0.03906529972665871,1,0.8106060606060606,0.8106060606060606,0.7744360902255639,0.8636363636363636,0.7424242424242424,0.8003417634996582,0.0406016284204163,5,0.6835443037974683,0.6951219512195121,0.6052631578947368,0.7464788732394366,0.6046511627906976,0.6670118897883702,0.05491860137984748,5,0.7588652482269503,0.7753623188405797,0.7152777777777778,0.7702702702702703,0.7368421052631579,0.7513235440757472,0.022372875386411317,1,0.6835443037974683,0.6951219512195121,0.6052631578947368,0.7464788732394366,0.6046511627906976,0.6670118897883702,0.05491860137984748,5,5,dfcmpltPreLC3_Holdout,Holdout,dfcmpltPreLC3,2024-05-03 23:11:16.815847
0.05670614242553711,0.017016516986842457,0.04351034164428711,0.008676161518491845,"XGBClassifier(base_score=None, booster=None, callbacks=None,
              colsample_bylevel=None, colsample_bynode=None,
              colsample_bytree=None, device='cpu', early_stopping_rounds=None,
              enable_categorical=False, eval_metric=None, feature_types=None,
              gamma=None, grow_policy=None, importance_type=None,
              interaction_constraints=None, learning_rate=None, max_bin=None,
              max_cat_threshold=None, max_cat_to_onehot=None,
              max_delta_step=None, max_depth=None, max_leaves=None,
              min_child_weight=None, missing=nan, monotone_constraints=None,
              multi_strategy=None, n_estimators=None, n_jobs=None,
              num_parallel_tree=None, random_state=None, ...)",3,10,42,,0.1,"{'clf': RandomForestClassifier(), 'clf__max_depth': 3, 'clf__n_estimators': 10, 'clf__random_state': 42}",0.6909090909090909,0.7363636363636363,0.7090909090909091,0.6666666666666666,0.7214611872146118,0.704898298048983,0.02424594957791302,4,0.6268939393939394,0.6988636363636364,0.6719384668567971,0.5902560083594567,0.6866509926854755,0.654920608731861,0.0404831302494043,4,0.7723829201101928,0.7676050275482094,0.7301875378100423,0.7178247997213515,0.737939742250087,0.7451880054879767,0.02129968375214877,4,0.4426229508196721,0.6081081081081081,0.5733333333333334,0.34234234234234234,0.5960264900662252,0.5124866449339363,0.10359025909142325,4,0.3068181818181818,0.5113636363636364,0.4942528735632184,0.21839080459770116,0.5172413793103449,0.40961337513061646,0.12347766671668073,4,0.3068181818181818,0.5113636363636364,0.4942528735632184,0.21839080459770116,0.5172413793103449,0.40961337513061646,0.12347766671668073,4,0.946969696969697,0.8863636363636364,0.849624060150376,0.9621212121212122,0.8560606060606061,0.9002278423331056,0.046301822722021116,2,0.7941176470588235,0.75,0.6825396825396826,0.7916666666666666,0.703125,0.7442897992530345,0.0453157941276805,2,0.6720430107526881,0.73125,0.7197452229299363,0.6512820512820513,0.7290322580645161,0.7006705086058383,0.032747800545942056,4,0.7941176470588235,0.75,0.6825396825396826,0.7916666666666666,0.703125,0.7442897992530345,0.0453157941276805,2,5,dfcmpltPreLC3_Holdout,Holdout,dfcmpltPreLC3,2024-05-03 23:11:16.815847
0.06051650047302246,0.004955829318370067,0.036926984786987305,0.007718977945292019,"XGBClassifier(base_score=None, booster=None, callbacks=None,
              colsample_bylevel=None, colsample_bynode=None,
              colsample_bytree=None, device='cpu', early_stopping_rounds=None,
              enable_categorical=False, eval_metric=None, feature_types=None,
              gamma=None, grow_policy=None, importance_type=None,
              interaction_constraints=None, learning_rate=None, max_bin=None,
              max_cat_threshold=None, max_cat_to_onehot=None,
              max_delta_step=None, max_depth=None, max_leaves=None,
              min_child_weight=None, missing=nan, monotone_constraints=None,
              multi_strategy=None, n_estimators=None, n_jobs=None,
              num_parallel_tree=None, random_state=None, ...)",3,10,42,,0.2,"{'clf': RandomForestClassifier(), 'clf__max_depth': 3, 'clf__n_estimators': 10, 'clf__random_state': 42}",0.7636363636363637,0.7318181818181818,0.7227272727272728,0.6986301369863014,0.7168949771689498,0.7267413864674139,0.02140243174927523,2,0.7386363636363636,0.7026515151515151,0.707069397632011,0.6598746081504703,0.6828631138975967,0.6982189996935914,0.026220738496188212,3,0.7882661845730028,0.7804321625344353,0.753046409126264,0.7470828979449669,0.7445576454197144,0.7626770599196767,0.018079200610666726,1,0.675,0.6242038216560509,0.6432748538011696,0.5540540540540541,0.5921052631578947,0.6177275985338339,0.04167866606325223,3,0.6136363636363636,0.5568181818181818,0.632183908045977,0.47126436781609193,0.5172413793103449,0.5582288401253919,0.05963912654913209,3,0.6136363636363636,0.5568181818181818,0.632183908045977,0.47126436781609193,0.5172413793103449,0.5582288401253919,0.05963912654913209,3,0.8636363636363636,0.8484848484848485,0.7819548872180451,0.8484848484848485,0.8484848484848485,0.838209159261791,0.02873275208713792,3,0.75,0.7101449275362319,0.6547619047619048,0.6721311475409836,0.6923076923076923,0.6958691344293625,0.032863137703781554,3,0.7702702702702703,0.7417218543046358,0.7647058823529411,0.7088607594936709,0.7272727272727273,0.7425662987388492,0.022927455120964755,3,0.75,0.7101449275362319,0.6547619047619048,0.6721311475409836,0.6923076923076923,0.6958691344293625,0.032863137703781554,3,5,dfcmpltPreLC3_Holdout,Holdout,dfcmpltPreLC3,2024-05-03 23:11:16.815847
0.06029996871948242,0.008510801245029639,0.03691806793212891,0.007617951225327044,"XGBClassifier(base_score=None, booster=None, callbacks=None,
              colsample_bylevel=None, colsample_bynode=None,
              colsample_bytree=None, device='cpu', early_stopping_rounds=None,
              enable_categorical=False, eval_metric=None, feature_types=None,
              gamma=None, grow_policy=None, importance_type=None,
              interaction_constraints=None, learning_rate=None, max_bin=None,
              max_cat_threshold=None, max_cat_to_onehot=None,
              max_delta_step=None, max_depth=None, max_leaves=None,
              min_child_weight=None, missing=nan, monotone_constraints=None,
              multi_strategy=None, n_estimators=None, n_jobs=None,
              num_parallel_tree=None, random_state=None, ...)",3,10,42,,1,"{'clf': RandomForestClassifier(), 'clf__max_depth': 3, 'clf__n_estimators': 10, 'clf__random_state': 42}",0.7227272727272728,0.7045454545454546,0.7,0.7579908675799086,0.7671232876712328,0.7304773765047737,0.027427410231523973,1,0.7026515151515151,0.6761363636363636,0.67237058162648,0.7326280041797284,0.740203761755486,0.7047980452699147,0.027948922543586847,1,0.7494404269972451,0.774578168044077,0.7072422435398842,0.7850923023336817,0.7772988505747126,0.7587303982979201,0.028383878725178658,2,0.6347305389221557,0.5911949685534591,0.5875,0.6666666666666666,0.6751592356687898,0.6310502819622142,0.03664080788872982,1,0.6022727272727273,0.5340909090909091,0.5402298850574713,0.6091954022988506,0.6091954022988506,0.5789968652037618,0.03430770375438367,2,0.6022727272727273,0.5340909090909091,0.5402298850574713,0.6091954022988506,0.6091954022988506,0.5789968652037618,0.03430770375438367,2,0.803030303030303,0.8181818181818182,0.8045112781954887,0.8560606060606061,0.8712121212121212,0.8305992253360674,0.027901640394014108,4,0.6708860759493671,0.6619718309859155,0.6438356164383562,0.7361111111111112,0.7571428571428571,0.6939894983255214,0.044355130502079884,4,0.75177304964539,0.7248322147651006,0.7278911564625851,0.7687074829931972,0.7718120805369127,0.7490031968806372,0.01972881535334854,2,0.6708860759493671,0.6619718309859155,0.6438356164383562,0.7361111111111112,0.7571428571428571,0.6939894983255214,0.044355130502079884,4,5,dfcmpltPreLC3_Holdout,Holdout,dfcmpltPreLC3,2024-05-03 23:11:16.815847
0.0118943214416503,0.0021227438858832,0.0144102573394775,0.0037181507375159,RandomForestClassifier(),3.0,10.0,42.0,,,"{'clf': RandomForestClassifier(), 'clf__max_depth': 3, 'clf__n_estimators': 10, 'clf__random_state': 42}",0.6363636363636364,0.6363636363636364,0.6181818181818182,0.6073059360730594,0.6255707762557078,0.6247571606475717,0.0111163203907138,5,0.5473484848484849,0.5492424242424242,0.5251922910725089,0.5057471264367817,0.5306948798328108,0.5316450412866021,0.0159342951665732,5,0.7663137052341598,0.7240444214876033,0.6626479993086163,0.7436868686868686,0.698493556252177,0.719037310193885,0.0359709038906273,5,0.1836734693877551,0.2,0.1428571428571428,0.0227272727272727,0.1276595744680851,0.1353834918880511,0.0621516743494864,5,0.1022727272727272,0.1136363636363636,0.0804597701149425,0.0114942528735632,0.0689655172413793,0.0753657262277951,0.0355952397365839,5,0.1022727272727272,0.1136363636363636,0.0804597701149425,0.0114942528735632,0.0689655172413793,0.0753657262277951,0.0355952397365839,5,0.9924242424242424,0.9848484848484848,0.9699248120300752,1.0,0.9924242424242424,0.987924356345409,0.0101957216531531,1,0.9,0.8333333333333334,0.6363636363636364,1.0,0.8571428571428571,0.8453679653679653,0.1190479024002924,1,0.6238095238095238,0.625,0.6172248803827751,0.6055045871559633,0.6179245283018868,0.6178927039300298,0.0069200412311113,5,0.9,0.8333333333333334,0.6363636363636364,1.0,0.8571428571428571,0.8453679653679653,0.1190479024002924,1,5,dfcmpltPreLC3_Holdout,Holdout,dfcmpltPreLC3,2024-05-03 23:09:58.991084
0.0593905448913574,0.0158321733925633,0.0446011066436767,0.0109230922395555,"XGBClassifier(base_score=None, booster=None, callbacks=None,
              colsample_bylevel=None, colsample_bynode=None,
              colsample_bytree=None, device='cpu', early_stopping_rounds=None,
              enable_categorical=False, eval_metric=None, feature_types=None,
              gamma=None, grow_policy=None, importance_type=None,
              interaction_constraints=None, learning_rate=None, max_bin=None,
              max_cat_threshold=None, max_cat_to_onehot=None,
              max_delta_step=None, max_depth=None, max_leaves=None,
              min_child_weight=None, missing=nan, monotone_constraints=None,
              multi_strategy=None, n_estimators=None, n_jobs=None,
              num_parallel_tree=None, random_state=None, ...)",3.0,10.0,42.0,,0.1,"{'clf': RandomForestClassifier(), 'clf__max_depth': 3, 'clf__n_estimators': 10, 'clf__random_state': 42}",0.6909090909090909,0.7363636363636363,0.7090909090909091,0.6666666666666666,0.7214611872146118,0.704898298048983,0.024245949577913,4,0.6268939393939394,0.6988636363636364,0.6719384668567971,0.5902560083594567,0.6866509926854755,0.654920608731861,0.0404831302494043,4,0.7723829201101928,0.7676050275482094,0.7301875378100423,0.7178247997213515,0.737939742250087,0.7451880054879767,0.0212996837521487,4,0.4426229508196721,0.6081081081081081,0.5733333333333334,0.3423423423423423,0.5960264900662252,0.5124866449339363,0.1035902590914232,4,0.3068181818181818,0.5113636363636364,0.4942528735632184,0.2183908045977011,0.5172413793103449,0.4096133751306164,0.1234776667166807,4,0.3068181818181818,0.5113636363636364,0.4942528735632184,0.2183908045977011,0.5172413793103449,0.4096133751306164,0.1234776667166807,4,0.946969696969697,0.8863636363636364,0.849624060150376,0.9621212121212122,0.8560606060606061,0.9002278423331056,0.0463018227220211,2,0.7941176470588235,0.75,0.6825396825396826,0.7916666666666666,0.703125,0.7442897992530345,0.0453157941276805,2,0.6720430107526881,0.73125,0.7197452229299363,0.6512820512820513,0.7290322580645161,0.7006705086058383,0.032747800545942,4,0.7941176470588235,0.75,0.6825396825396826,0.7916666666666666,0.703125,0.7442897992530345,0.0453157941276805,2,5,dfcmpltPreLC3_Holdout,Holdout,dfcmpltPreLC3,2024-05-03 23:09:58.991084
