mean_fit_time,std_fit_time,mean_score_time,std_score_time,param_clf,param_clf__max_depth,param_clf__n_estimators,param_clf__random_state,param_clf__max_iter,param_clf__learning_rate,params,split0_test_accuracy,split1_test_accuracy,split2_test_accuracy,split3_test_accuracy,split4_test_accuracy,mean_test_accuracy,std_test_accuracy,rank_test_accuracy,split0_test_balanced_accuracy,split1_test_balanced_accuracy,split2_test_balanced_accuracy,split3_test_balanced_accuracy,split4_test_balanced_accuracy,mean_test_balanced_accuracy,std_test_balanced_accuracy,rank_test_balanced_accuracy,split0_test_roc_auc,split1_test_roc_auc,split2_test_roc_auc,split3_test_roc_auc,split4_test_roc_auc,mean_test_roc_auc,std_test_roc_auc,rank_test_roc_auc,split0_test_f1,split1_test_f1,split2_test_f1,split3_test_f1,split4_test_f1,mean_test_f1,std_test_f1,rank_test_f1,split0_test_recall,split1_test_recall,split2_test_recall,split3_test_recall,split4_test_recall,mean_test_recall,std_test_recall,rank_test_recall,split0_test_sensitivity,split1_test_sensitivity,split2_test_sensitivity,split3_test_sensitivity,split4_test_sensitivity,mean_test_sensitivity,std_test_sensitivity,rank_test_sensitivity,split0_test_specificity,split1_test_specificity,split2_test_specificity,split3_test_specificity,split4_test_specificity,mean_test_specificity,std_test_specificity,rank_test_specificity,split0_test_precision,split1_test_precision,split2_test_precision,split3_test_precision,split4_test_precision,mean_test_precision,std_test_precision,rank_test_precision,split0_test_NPV,split1_test_NPV,split2_test_NPV,split3_test_NPV,split4_test_NPV,mean_test_NPV,std_test_NPV,rank_test_NPV,split0_test_PPV,split1_test_PPV,split2_test_PPV,split3_test_PPV,split4_test_PPV,mean_test_PPV,std_test_PPV,rank_test_PPV,cv,Title,RunType,MainDataset,date
0.018236207962036132,0.004140967465151517,0.013870143890380859,0.0020145854864364334,RandomForestClassifier(),3,10,42,,,"{'clf': RandomForestClassifier(), 'clf__max_depth': 3, 'clf__n_estimators': 10, 'clf__random_state': 42}",0.690846286701209,0.6925734024179621,0.6885813148788927,0.6955017301038062,0.6955017301038062,0.6926008928411352,0.0026857445549858185,5,0.5,0.504336592178771,0.49874686716791977,0.5083798882681564,0.5114602147827669,0.5045847124795229,0.0048339938203164606,5,0.6926466480446927,0.6826815642458101,0.6562355609694628,0.6819982918189328,0.6919813500231026,0.6811086830204002,0.013215726119876666,5,0.0,0.02197802197802198,0.0,0.03296703296703297,0.053763440860215055,0.021741699161054,0.02047856866969377,5,0.0,0.0111731843575419,0.0,0.01675977653631285,0.027932960893854747,0.011173184357541898,0.010599813386039261,5,0.0,0.0111731843575419,0.0,0.01675977653631285,0.027932960893854747,0.011173184357541898,0.010599813386039261,5,1.0,0.9975,0.9974937343358395,1.0,0.9949874686716792,0.9979962406015037,0.0018751842182269346,1,0.0,0.6666666666666666,0.0,1.0,0.7142857142857143,0.47619047619047616,0.40518185497490755,5,0.690846286701209,0.6927083333333334,0.6897746967071057,0.6939130434782609,0.6952714535901926,0.6925027627620203,0.0019941442876790024,5,0.0,0.6666666666666666,0.0,1.0,0.7142857142857143,0.47619047619047616,0.40518185497490755,5,5,dfcmpltPreLC3_SITE2_Full,Full,dfcmpltPreLC3_SITE2,2024-05-03 23:11:21.839659
0.21262335777282715,0.03294748344308275,0.012517356872558593,0.0026784582683921352,LogisticRegression(),,,,1000,,"{'clf': RandomForestClassifier(), 'clf__max_depth': 3, 'clf__n_estimators': 10, 'clf__random_state': 42}",0.7357512953367875,0.7115716753022453,0.7110726643598616,0.7301038062283737,0.6937716262975778,0.7164542135049692,0.015006590296678925,1,0.6359008379888268,0.5998812849162011,0.5982064098794473,0.6289326668626875,0.5872152448159504,0.6100272888926226,0.018920453437031713,1,0.7423254189944135,0.7150977653631284,0.6779868666078606,0.730079388415172,0.6967978605732208,0.7124574599907592,0.022991491517452133,2,0.46689895470383275,0.3971119133574007,0.3927272727272727,0.45454545454545453,0.3832752613240418,0.4189117713316005,0.03465069052056453,2,0.3743016759776536,0.30726256983240224,0.3016759776536313,0.36312849162011174,0.30726256983240224,0.3307262569832402,0.031284916201117306,2,0.3743016759776536,0.30726256983240224,0.3016759776536313,0.36312849162011174,0.30726256983240224,0.3307262569832402,0.031284916201117306,2,0.8975,0.8925,0.8947368421052632,0.8947368421052632,0.8671679197994987,0.8893283208020051,0.011193064529586298,4,0.6203703703703703,0.5612244897959183,0.5625,0.6074766355140186,0.5092592592592593,0.5721661509879133,0.03934694025019612,3,0.7622080679405521,0.7422037422037422,0.7406639004149378,0.7579617834394905,0.7361702127659574,0.7478415413529359,0.010279490315670816,1,0.6203703703703703,0.5612244897959183,0.5625,0.6074766355140186,0.5092592592592593,0.5721661509879133,0.03934694025019612,3,5,dfcmpltPreLC3_SITE2_Full,Full,dfcmpltPreLC3_SITE2,2024-05-03 23:11:21.839659
0.13754768371582032,0.0114007825211021,0.04439458847045898,0.007546199725986871,"XGBClassifier(base_score=None, booster=None, callbacks=None,
              colsample_bylevel=None, colsample_bynode=None,
              colsample_bytree=None, device='cpu', early_stopping_rounds=None,
              enable_categorical=False, eval_metric=None, feature_types=None,
              gamma=None, grow_policy=None, importance_type=None,
              interaction_constraints=None, learning_rate=None, max_bin=None,
              max_cat_threshold=None, max_cat_to_onehot=None,
              max_delta_step=None, max_depth=None, max_leaves=None,
              min_child_weight=None, missing=nan, monotone_constraints=None,
              multi_strategy=None, n_estimators=None, n_jobs=None,
              num_parallel_tree=None, random_state=None, ...)",3,10,42,,0.1,"{'clf': RandomForestClassifier(), 'clf__max_depth': 3, 'clf__n_estimators': 10, 'clf__random_state': 42}",0.7012089810017271,0.6994818652849741,0.6937716262975778,0.7024221453287197,0.6937716262975778,0.6981312488421152,0.0036802448326833494,4,0.5183030726256983,0.5216829608938548,0.5086669186933815,0.5195530726256983,0.5071267554360762,0.5150665560549419,0.005972879969858116,4,0.7066759776536313,0.7184287709497207,0.6745495022472383,0.7301984010305091,0.6771607790425784,0.7014026861847356,0.02216146163180363,3,0.0748663101604278,0.10309278350515463,0.043243243243243246,0.07526881720430108,0.03278688524590164,0.06585160787180568,0.02514465305000041,4,0.03910614525139665,0.055865921787709494,0.0223463687150838,0.03910614525139665,0.01675977653631285,0.03463687150837989,0.013865557146358497,4,0.03910614525139665,0.055865921787709494,0.0223463687150838,0.03910614525139665,0.01675977653631285,0.03463687150837989,0.013865557146358497,4,0.9975,0.9875,0.9949874686716792,1.0,0.9974937343358395,0.9954962406015037,0.004300874197161086,2,0.875,0.6666666666666666,0.6666666666666666,1.0,0.75,0.7916666666666666,0.12909944487358058,1,0.6987740805604203,0.700354609929078,0.6940559440559441,0.6987740805604203,0.6933797909407665,0.6970677012093258,0.0028035189748442267,4,0.875,0.6666666666666666,0.6666666666666666,1.0,0.75,0.7916666666666666,0.12909944487358058,1,5,dfcmpltPreLC3_SITE2_Full,Full,dfcmpltPreLC3_SITE2,2024-05-03 23:11:21.839659
0.13471441268920897,0.016723223248797537,0.04907283782958984,0.014194085447141735,"XGBClassifier(base_score=None, booster=None, callbacks=None,
              colsample_bylevel=None, colsample_bynode=None,
              colsample_bytree=None, device='cpu', early_stopping_rounds=None,
              enable_categorical=False, eval_metric=None, feature_types=None,
              gamma=None, grow_policy=None, importance_type=None,
              interaction_constraints=None, learning_rate=None, max_bin=None,
              max_cat_threshold=None, max_cat_to_onehot=None,
              max_delta_step=None, max_depth=None, max_leaves=None,
              min_child_weight=None, missing=nan, monotone_constraints=None,
              multi_strategy=None, n_estimators=None, n_jobs=None,
              num_parallel_tree=None, random_state=None, ...)",3,10,42,,0.2,"{'clf': RandomForestClassifier(), 'clf__max_depth': 3, 'clf__n_estimators': 10, 'clf__random_state': 42}",0.7253886010362695,0.7115716753022453,0.7162629757785467,0.7214532871972318,0.6955017301038062,0.7140356538836199,0.010377371314307823,2,0.5929050279329608,0.5612988826815642,0.569622379972277,0.581082594755044,0.5407233166715671,0.5691264404026827,0.017757392294206812,3,0.7185125698324023,0.7307262569832401,0.6857506895730947,0.7390403382758572,0.6929544531720363,0.7133968615673261,0.020814750544601246,1,0.3562753036437247,0.2643171806167401,0.28695652173913044,0.3206751054852321,0.21428571428571427,0.2885019651541083,0.048422475071442844,3,0.24581005586592178,0.16759776536312848,0.18435754189944134,0.2122905027932961,0.1340782122905028,0.1888268156424581,0.03812004940610498,3,0.24581005586592178,0.16759776536312848,0.18435754189944134,0.2122905027932961,0.1340782122905028,0.1888268156424581,0.03812004940610498,3,0.94,0.955,0.9548872180451128,0.949874686716792,0.9473684210526315,0.9494260651629073,0.005552995685384863,3,0.6470588235294118,0.625,0.6470588235294118,0.6551724137931034,0.5333333333333333,0.621524678837052,0.04522376905335364,2,0.735812133072407,0.71939736346516,0.7229601518026565,0.7288461538461538,0.7091932457786116,0.7232418095929979,0.008962621818111662,3,0.6470588235294118,0.625,0.6470588235294118,0.6551724137931034,0.5333333333333333,0.621524678837052,0.04522376905335364,2,5,dfcmpltPreLC3_SITE2_Full,Full,dfcmpltPreLC3_SITE2,2024-05-03 23:11:21.839659
0.12103948593139649,0.015242310378578003,0.039722251892089847,0.005568875993976145,"XGBClassifier(base_score=None, booster=None, callbacks=None,
              colsample_bylevel=None, colsample_bynode=None,
              colsample_bytree=None, device='cpu', early_stopping_rounds=None,
              enable_categorical=False, eval_metric=None, feature_types=None,
              gamma=None, grow_policy=None, importance_type=None,
              interaction_constraints=None, learning_rate=None, max_bin=None,
              max_cat_threshold=None, max_cat_to_onehot=None,
              max_delta_step=None, max_depth=None, max_leaves=None,
              min_child_weight=None, missing=nan, monotone_constraints=None,
              multi_strategy=None, n_estimators=None, n_jobs=None,
              num_parallel_tree=None, random_state=None, ...)",3,10,42,,1,"{'clf': RandomForestClassifier(), 'clf__max_depth': 3, 'clf__n_estimators': 10, 'clf__random_state': 42}",0.7081174438687392,0.7046632124352331,0.698961937716263,0.7041522491349481,0.6885813148788927,0.7008952316068152,0.006816690738292746,3,0.6189874301675977,0.597967877094972,0.6032959493706334,0.6039750213522633,0.5957771523781521,0.6040006860727237,0.008113212700899522,2,0.7222695530726257,0.7081284916201116,0.6647764663054284,0.6962027974965347,0.6901401548564147,0.696303492670223,0.01921466709010422,4,0.4495114006514658,0.4,0.42,0.41638225255972694,0.4117647058823529,0.4195316718187091,0.0164361447896405,1,0.3854748603351955,0.31843575418994413,0.35195530726256985,0.3407821229050279,0.35195530726256985,0.34972067039106147,0.021665608301302028,1,0.3854748603351955,0.31843575418994413,0.35195530726256985,0.3407821229050279,0.35195530726256985,0.34972067039106147,0.021665608301302028,1,0.8525,0.8775,0.8546365914786967,0.8671679197994987,0.8395989974937343,0.8582807017543861,0.012992814908188537,5,0.5390625,0.5377358490566038,0.5206611570247934,0.5350877192982456,0.49606299212598426,0.5257220435011254,0.01621904489826422,4,0.7560975609756098,0.7420718816067653,0.7461706783369803,0.7456896551724138,0.7427937915742794,0.7465647135332096,0.005023973773226942,2,0.5390625,0.5377358490566038,0.5206611570247934,0.5350877192982456,0.49606299212598426,0.5257220435011254,0.01621904489826422,4,5,dfcmpltPreLC3_SITE2_Full,Full,dfcmpltPreLC3_SITE2,2024-05-03 23:11:21.839659
0.0147019863128662,0.0011854484838615,0.0125936031341552,0.0006743225949079,RandomForestClassifier(),3.0,10.0,42.0,,,"{'clf': RandomForestClassifier(), 'clf__max_depth': 3, 'clf__n_estimators': 10, 'clf__random_state': 42}",0.690846286701209,0.6925734024179621,0.6885813148788927,0.6955017301038062,0.6955017301038062,0.6926008928411352,0.0026857445549858,5,0.5,0.504336592178771,0.4987468671679197,0.5083798882681564,0.5114602147827669,0.5045847124795229,0.0048339938203164,5,0.6926466480446927,0.6826815642458101,0.6562355609694628,0.6819982918189328,0.6919813500231026,0.6811086830204002,0.0132157261198766,5,0.0,0.0219780219780219,0.0,0.0329670329670329,0.053763440860215,0.021741699161054,0.0204785686696937,5,0.0,0.0111731843575419,0.0,0.0167597765363128,0.0279329608938547,0.0111731843575418,0.0105998133860392,5,0.0,0.0111731843575419,0.0,0.0167597765363128,0.0279329608938547,0.0111731843575418,0.0105998133860392,5,1.0,0.9975,0.9974937343358397,1.0,0.9949874686716792,0.9979962406015036,0.0018751842182269,1,0.0,0.6666666666666666,0.0,1.0,0.7142857142857143,0.4761904761904761,0.4051818549749075,5,0.690846286701209,0.6927083333333334,0.6897746967071057,0.6939130434782609,0.6952714535901926,0.6925027627620203,0.001994144287679,5,0.0,0.6666666666666666,0.0,1.0,0.7142857142857143,0.4761904761904761,0.4051818549749075,5,5,dfcmpltPreLC3_SITE2_Full,Full,dfcmpltPreLC3_SITE2,2024-05-03 23:07:48.813196
0.1311892986297607,0.0191412293136809,0.0449686527252197,0.0056839682075579,"XGBClassifier(base_score=None, booster=None, callbacks=None,
              colsample_bylevel=None, colsample_bynode=None,
              colsample_bytree=None, device='cpu', early_stopping_rounds=None,
              enable_categorical=False, eval_metric=None, feature_types=None,
              gamma=None, grow_policy=None, importance_type=None,
              interaction_constraints=None, learning_rate=None, max_bin=None,
              max_cat_threshold=None, max_cat_to_onehot=None,
              max_delta_step=None, max_depth=None, max_leaves=None,
              min_child_weight=None, missing=nan, monotone_constraints=None,
              multi_strategy=None, n_estimators=None, n_jobs=None,
              num_parallel_tree=None, random_state=None, ...)",3.0,10.0,42.0,,0.1,"{'clf': RandomForestClassifier(), 'clf__max_depth': 3, 'clf__n_estimators': 10, 'clf__random_state': 42}",0.7012089810017271,0.6994818652849741,0.6937716262975778,0.7024221453287197,0.6937716262975778,0.6981312488421152,0.0036802448326833,4,0.5183030726256983,0.5216829608938548,0.5086669186933815,0.5195530726256983,0.5071267554360762,0.5150665560549419,0.0059728799698581,4,0.7066759776536313,0.7184287709497207,0.6745495022472383,0.7301984010305091,0.6771607790425784,0.7014026861847356,0.0221614616318036,3,0.0748663101604278,0.1030927835051546,0.0432432432432432,0.075268817204301,0.0327868852459016,0.0658516078718056,0.0251446530500004,4,0.0391061452513966,0.0558659217877094,0.0223463687150838,0.0391061452513966,0.0167597765363128,0.0346368715083798,0.0138655571463584,4,0.0391061452513966,0.0558659217877094,0.0223463687150838,0.0391061452513966,0.0167597765363128,0.0346368715083798,0.0138655571463584,4,0.9975,0.9875,0.9949874686716792,1.0,0.9974937343358397,0.9954962406015035,0.004300874197161,2,0.875,0.6666666666666666,0.6666666666666666,1.0,0.75,0.7916666666666666,0.1290994448735805,1,0.6987740805604203,0.700354609929078,0.6940559440559441,0.6987740805604203,0.6933797909407665,0.6970677012093258,0.0028035189748442,4,0.875,0.6666666666666666,0.6666666666666666,1.0,0.75,0.7916666666666666,0.1290994448735805,1,5,dfcmpltPreLC3_SITE2_Full,Full,dfcmpltPreLC3_SITE2,2024-05-03 23:07:48.813196
0.1354734420776367,0.0091312542634187,0.0418609142303466,0.0062164847366811,"XGBClassifier(base_score=None, booster=None, callbacks=None,
              colsample_bylevel=None, colsample_bynode=None,
              colsample_bytree=None, device='cpu', early_stopping_rounds=None,
              enable_categorical=False, eval_metric=None, feature_types=None,
              gamma=None, grow_policy=None, importance_type=None,
              interaction_constraints=None, learning_rate=None, max_bin=None,
              max_cat_threshold=None, max_cat_to_onehot=None,
              max_delta_step=None, max_depth=None, max_leaves=None,
              min_child_weight=None, missing=nan, monotone_constraints=None,
              multi_strategy=None, n_estimators=None, n_jobs=None,
              num_parallel_tree=None, random_state=None, ...)",3.0,10.0,42.0,,0.2,"{'clf': RandomForestClassifier(), 'clf__max_depth': 3, 'clf__n_estimators': 10, 'clf__random_state': 42}",0.7253886010362695,0.7115716753022453,0.7162629757785467,0.7214532871972318,0.6955017301038062,0.7140356538836199,0.0103773713143078,2,0.5929050279329608,0.5612988826815642,0.569622379972277,0.581082594755044,0.5407233166715671,0.5691264404026827,0.0177573922942068,3,0.7185125698324023,0.7307262569832401,0.6857506895730947,0.7390403382758572,0.6929544531720363,0.7133968615673261,0.0208147505446012,1,0.3562753036437247,0.2643171806167401,0.2869565217391304,0.3206751054852321,0.2142857142857142,0.2885019651541083,0.0484224750714428,3,0.2458100558659217,0.1675977653631284,0.1843575418994413,0.2122905027932961,0.1340782122905028,0.1888268156424581,0.0381200494061049,3,0.2458100558659217,0.1675977653631284,0.1843575418994413,0.2122905027932961,0.1340782122905028,0.1888268156424581,0.0381200494061049,3,0.94,0.955,0.9548872180451128,0.949874686716792,0.9473684210526316,0.9494260651629072,0.0055529956853848,3,0.6470588235294118,0.625,0.6470588235294118,0.6551724137931034,0.5333333333333333,0.621524678837052,0.0452237690533536,2,0.735812133072407,0.71939736346516,0.7229601518026565,0.7288461538461538,0.7091932457786116,0.7232418095929979,0.0089626218181116,3,0.6470588235294118,0.625,0.6470588235294118,0.6551724137931034,0.5333333333333333,0.621524678837052,0.0452237690533536,2,5,dfcmpltPreLC3_SITE2_Full,Full,dfcmpltPreLC3_SITE2,2024-05-03 23:07:48.813196
0.1218151092529296,0.0124856037647793,0.0430018424987792,0.0085189901806071,"XGBClassifier(base_score=None, booster=None, callbacks=None,
              colsample_bylevel=None, colsample_bynode=None,
              colsample_bytree=None, device='cpu', early_stopping_rounds=None,
              enable_categorical=False, eval_metric=None, feature_types=None,
              gamma=None, grow_policy=None, importance_type=None,
              interaction_constraints=None, learning_rate=None, max_bin=None,
              max_cat_threshold=None, max_cat_to_onehot=None,
              max_delta_step=None, max_depth=None, max_leaves=None,
              min_child_weight=None, missing=nan, monotone_constraints=None,
              multi_strategy=None, n_estimators=None, n_jobs=None,
              num_parallel_tree=None, random_state=None, ...)",3.0,10.0,42.0,,1.0,"{'clf': RandomForestClassifier(), 'clf__max_depth': 3, 'clf__n_estimators': 10, 'clf__random_state': 42}",0.7081174438687392,0.7046632124352331,0.698961937716263,0.7041522491349481,0.6885813148788927,0.7008952316068152,0.0068166907382927,3,0.6189874301675977,0.597967877094972,0.6032959493706334,0.6039750213522633,0.5957771523781521,0.6040006860727237,0.0081132127008995,2,0.7222695530726257,0.7081284916201116,0.6647764663054284,0.6962027974965347,0.6901401548564147,0.696303492670223,0.0192146670901042,4,0.4495114006514658,0.4,0.42,0.4163822525597269,0.4117647058823529,0.4195316718187091,0.0164361447896405,1,0.3854748603351955,0.3184357541899441,0.3519553072625698,0.3407821229050279,0.3519553072625698,0.3497206703910614,0.021665608301302,1,0.3854748603351955,0.3184357541899441,0.3519553072625698,0.3407821229050279,0.3519553072625698,0.3497206703910614,0.021665608301302,1,0.8525,0.8775,0.8546365914786967,0.8671679197994987,0.8395989974937343,0.8582807017543861,0.0129928149081885,5,0.5390625,0.5377358490566038,0.5206611570247934,0.5350877192982456,0.4960629921259842,0.5257220435011254,0.0162190448982642,4,0.7560975609756098,0.7420718816067653,0.7461706783369803,0.7456896551724138,0.7427937915742794,0.7465647135332096,0.0050239737732269,2,0.5390625,0.5377358490566038,0.5206611570247934,0.5350877192982456,0.4960629921259842,0.5257220435011254,0.0162190448982642,4,5,dfcmpltPreLC3_SITE2_Full,Full,dfcmpltPreLC3_SITE2,2024-05-03 23:07:48.813196
