mean_fit_time,std_fit_time,mean_score_time,std_score_time,param_clf,param_clf__max_depth,param_clf__n_estimators,param_clf__random_state,param_clf__max_iter,param_clf__learning_rate,params,split0_test_accuracy,split1_test_accuracy,split2_test_accuracy,split3_test_accuracy,split4_test_accuracy,mean_test_accuracy,std_test_accuracy,rank_test_accuracy,split0_test_balanced_accuracy,split1_test_balanced_accuracy,split2_test_balanced_accuracy,split3_test_balanced_accuracy,split4_test_balanced_accuracy,mean_test_balanced_accuracy,std_test_balanced_accuracy,rank_test_balanced_accuracy,split0_test_roc_auc,split1_test_roc_auc,split2_test_roc_auc,split3_test_roc_auc,split4_test_roc_auc,mean_test_roc_auc,std_test_roc_auc,rank_test_roc_auc,split0_test_f1,split1_test_f1,split2_test_f1,split3_test_f1,split4_test_f1,mean_test_f1,std_test_f1,rank_test_f1,split0_test_recall,split1_test_recall,split2_test_recall,split3_test_recall,split4_test_recall,mean_test_recall,std_test_recall,rank_test_recall,split0_test_sensitivity,split1_test_sensitivity,split2_test_sensitivity,split3_test_sensitivity,split4_test_sensitivity,mean_test_sensitivity,std_test_sensitivity,rank_test_sensitivity,split0_test_specificity,split1_test_specificity,split2_test_specificity,split3_test_specificity,split4_test_specificity,mean_test_specificity,std_test_specificity,rank_test_specificity,split0_test_precision,split1_test_precision,split2_test_precision,split3_test_precision,split4_test_precision,mean_test_precision,std_test_precision,rank_test_precision,split0_test_NPV,split1_test_NPV,split2_test_NPV,split3_test_NPV,split4_test_NPV,mean_test_NPV,std_test_NPV,rank_test_NPV,split0_test_PPV,split1_test_PPV,split2_test_PPV,split3_test_PPV,split4_test_PPV,mean_test_PPV,std_test_PPV,rank_test_PPV,cv,Title,RunType,MainDataset,date
0.011021852493286133,0.0024071089672879184,0.013387250900268554,0.003005200233250181,RandomForestClassifier(),3,10,42,,,"{'clf': RandomForestClassifier(), 'clf__max_depth': 3, 'clf__n_estimators': 10, 'clf__random_state': 42}",0.7910447761194029,0.8059701492537313,0.8208955223880597,0.7761194029850746,0.835820895522388,0.8059701492537312,0.021107665110046192,5,0.6314016172506739,0.6145552560646901,0.6502695417789758,0.5431266846361186,0.657051282051282,0.619280876356348,0.04087934856272846,5,0.9056603773584907,0.9258760107816711,0.8908355795148248,0.8807277628032345,0.9301282051282052,0.9066455871172853,0.019203661832011273,5,0.8727272727272727,0.8849557522123894,0.8928571428571429,0.8695652173913043,0.9026548672566371,0.8845520504889492,0.01233920617106242,5,0.9056603773584906,0.9433962264150944,0.9433962264150944,0.9433962264150944,0.9807692307692307,0.943323657474601,0.023751671213712345,1,0.9056603773584906,0.9433962264150944,0.9433962264150944,0.9433962264150944,0.9807692307692307,0.943323657474601,0.023751671213712345,1,0.35714285714285715,0.2857142857142857,0.35714285714285715,0.14285714285714285,0.3333333333333333,0.2952380952380952,0.08053111678708459,5,0.8421052631578947,0.8333333333333334,0.847457627118644,0.8064516129032258,0.8360655737704918,0.8330826820567181,0.014186051801381229,5,0.5,0.5714285714285714,0.625,0.4,0.8333333333333334,0.585952380952381,0.14484411825857588,5,0.8421052631578947,0.8333333333333334,0.847457627118644,0.8064516129032258,0.8360655737704918,0.8330826820567181,0.014186051801381229,5,5,dfcmpltPreLC3_SITE3_Full,Full,dfcmpltPreLC3_SITE3,2024-05-03 23:11:23.856868
0.023938083648681642,0.0052767820932702785,0.01112208366394043,0.0024545067295422838,LogisticRegression(),,,,1000,,"{'clf': RandomForestClassifier(), 'clf__max_depth': 3, 'clf__n_estimators': 10, 'clf__random_state': 42}",0.8955223880597015,0.8955223880597015,0.8507462686567164,0.8955223880597015,0.8955223880597015,0.8865671641791044,0.017910447761194038,1,0.8814016172506738,0.8025606469002695,0.7742587601078168,0.8288409703504043,0.8378205128205127,0.8249765014859355,0.03588441517744095,2,0.9407008086253369,0.9555256064690028,0.9245283018867925,0.944743935309973,0.9596153846153845,0.945022807381298,0.012345317309429388,1,0.9320388349514563,0.9357798165137615,0.9056603773584906,0.9345794392523364,0.9333333333333333,0.9282783602818757,0.011377543808792322,1,0.9056603773584906,0.9622641509433962,0.9056603773584906,0.9433962264150944,0.9423076923076923,0.9318577648766329,0.022536599642277264,2,0.9056603773584906,0.9622641509433962,0.9056603773584906,0.9433962264150944,0.9423076923076923,0.9318577648766329,0.022536599642277264,2,0.8571428571428571,0.6428571428571429,0.6428571428571429,0.7142857142857143,0.7333333333333333,0.7180952380952381,0.07861614888948165,2,0.96,0.9107142857142857,0.9056603773584906,0.9259259259259259,0.9245283018867925,0.925365778177099,0.018992174736586324,2,0.7058823529411765,0.8181818181818182,0.6428571428571429,0.7692307692307693,0.7857142857142857,0.7443732737850385,0.06254878320018413,1,0.96,0.9107142857142857,0.9056603773584906,0.9259259259259259,0.9245283018867925,0.925365778177099,0.018992174736586324,2,5,dfcmpltPreLC3_SITE3_Full,Full,dfcmpltPreLC3_SITE3,2024-05-03 23:11:23.856868
0.029744958877563475,0.0052838571182291195,0.02846999168395996,0.0018073002962671735,"XGBClassifier(base_score=None, booster=None, callbacks=None,
              colsample_bylevel=None, colsample_bynode=None,
              colsample_bytree=None, device='cpu', early_stopping_rounds=None,
              enable_categorical=False, eval_metric=None, feature_types=None,
              gamma=None, grow_policy=None, importance_type=None,
              interaction_constraints=None, learning_rate=None, max_bin=None,
              max_cat_threshold=None, max_cat_to_onehot=None,
              max_delta_step=None, max_depth=None, max_leaves=None,
              min_child_weight=None, missing=nan, monotone_constraints=None,
              multi_strategy=None, n_estimators=None, n_jobs=None,
              num_parallel_tree=None, random_state=None, ...)",3,10,42,,0.1,"{'clf': RandomForestClassifier(), 'clf__max_depth': 3, 'clf__n_estimators': 10, 'clf__random_state': 42}",0.9104477611940298,0.835820895522388,0.8208955223880597,0.8955223880597015,0.7910447761194029,0.8507462686567164,0.0452708981734421,3,0.9171159029649596,0.7648247978436657,0.8342318059299192,0.9076819407008087,0.5807692307692308,0.8009247356417168,0.12310848952191104,3,0.942722371967655,0.9319407008086253,0.8962264150943398,0.9474393530997305,0.9474358974358974,0.9331529476812495,0.019311738741089785,2,0.9411764705882353,0.8952380952380953,0.8775510204081632,0.9306930693069307,0.8771929824561403,0.904370327599513,0.026791266815403163,3,0.9056603773584906,0.8867924528301887,0.8113207547169812,0.8867924528301887,0.9615384615384616,0.8904208998548621,0.04811052581475227,3,0.9056603773584906,0.8867924528301887,0.8113207547169812,0.8867924528301887,0.9615384615384616,0.8904208998548621,0.04811052581475227,3,0.9285714285714286,0.6428571428571429,0.8571428571428571,0.9285714285714286,0.2,0.7114285714285715,0.27633165521429026,3,0.9795918367346939,0.9038461538461539,0.9555555555555556,0.9791666666666666,0.8064516129032258,0.9249223651412593,0.06534388042601182,3,0.7222222222222222,0.6,0.5454545454545454,0.6842105263157895,0.6,0.6303774587985115,0.06386069361291734,3,0.9795918367346939,0.9038461538461539,0.9555555555555556,0.9791666666666666,0.8064516129032258,0.9249223651412593,0.06534388042601182,3,5,dfcmpltPreLC3_SITE3_Full,Full,dfcmpltPreLC3_SITE3,2024-05-03 23:11:23.856868
0.033993101119995116,0.007002277647585752,0.03492116928100586,0.009126884735292884,"XGBClassifier(base_score=None, booster=None, callbacks=None,
              colsample_bylevel=None, colsample_bynode=None,
              colsample_bytree=None, device='cpu', early_stopping_rounds=None,
              enable_categorical=False, eval_metric=None, feature_types=None,
              gamma=None, grow_policy=None, importance_type=None,
              interaction_constraints=None, learning_rate=None, max_bin=None,
              max_cat_threshold=None, max_cat_to_onehot=None,
              max_delta_step=None, max_depth=None, max_leaves=None,
              min_child_weight=None, missing=nan, monotone_constraints=None,
              multi_strategy=None, n_estimators=None, n_jobs=None,
              num_parallel_tree=None, random_state=None, ...)",3,10,42,,0.2,"{'clf': RandomForestClassifier(), 'clf__max_depth': 3, 'clf__n_estimators': 10, 'clf__random_state': 42}",0.9253731343283582,0.8507462686567164,0.8208955223880597,0.8955223880597015,0.9253731343283582,0.8835820895522388,0.04157727843935557,2,0.9528301886792453,0.8530997304582211,0.8342318059299192,0.9076819407008087,0.9282051282051282,0.8952097587946645,0.04484624596594006,1,0.9454177897574124,0.940700808625337,0.8706199460916442,0.9305929919137466,0.9487179487179488,0.9272098970212177,0.028948216590510667,3,0.9504950495049505,0.9,0.8775510204081632,0.9306930693069307,0.9504950495049505,0.9218468377449989,0.028841288597869514,2,0.9056603773584906,0.8490566037735849,0.8113207547169812,0.8867924528301887,0.9230769230769231,0.8751814223512338,0.0402950436984244,5,0.9056603773584906,0.8490566037735849,0.8113207547169812,0.8867924528301887,0.9230769230769231,0.8751814223512338,0.0402950436984244,5,1.0,0.8571428571428571,0.8571428571428571,0.9285714285714286,0.9333333333333333,0.9152380952380954,0.05373994658920339,1,1.0,0.9574468085106383,0.9555555555555556,0.9791666666666666,0.9795918367346939,0.974352173493511,0.016416751390040164,1,0.7368421052631579,0.6,0.5454545454545454,0.6842105263157895,0.7777777777777778,0.6688569909622541,0.08566316988826753,2,1.0,0.9574468085106383,0.9555555555555556,0.9791666666666666,0.9795918367346939,0.974352173493511,0.016416751390040164,1,5,dfcmpltPreLC3_SITE3_Full,Full,dfcmpltPreLC3_SITE3,2024-05-03 23:11:23.856868
0.02822136878967285,0.006392875581114376,0.03540482521057129,0.008273982302603542,"XGBClassifier(base_score=None, booster=None, callbacks=None,
              colsample_bylevel=None, colsample_bynode=None,
              colsample_bytree=None, device='cpu', early_stopping_rounds=None,
              enable_categorical=False, eval_metric=None, feature_types=None,
              gamma=None, grow_policy=None, importance_type=None,
              interaction_constraints=None, learning_rate=None, max_bin=None,
              max_cat_threshold=None, max_cat_to_onehot=None,
              max_delta_step=None, max_depth=None, max_leaves=None,
              min_child_weight=None, missing=nan, monotone_constraints=None,
              multi_strategy=None, n_estimators=None, n_jobs=None,
              num_parallel_tree=None, random_state=None, ...)",3,10,42,,1,"{'clf': RandomForestClassifier(), 'clf__max_depth': 3, 'clf__n_estimators': 10, 'clf__random_state': 42}",0.8656716417910447,0.8208955223880597,0.7910447761194029,0.835820895522388,0.8656716417910447,0.8358208955223881,0.028318904419418308,4,0.8362533692722371,0.7553908355795149,0.6576819407008087,0.7648247978436657,0.7948717948717949,0.7618045476536043,0.059207845377818306,4,0.9029649595687332,0.921832884097035,0.8584905660377359,0.915768194070081,0.9403846153846155,0.90788824383164,0.027484286679353244,4,0.912621359223301,0.8846153846153846,0.8703703703703703,0.8952380952380953,0.9142857142857143,0.895426184746573,0.016709628906216238,4,0.8867924528301887,0.8679245283018868,0.8867924528301887,0.8867924528301887,0.9230769230769231,0.8902757619738753,0.01795491099470783,4,0.8867924528301887,0.8679245283018868,0.8867924528301887,0.8867924528301887,0.9230769230769231,0.8902757619738753,0.01795491099470783,4,0.7857142857142857,0.6428571428571429,0.42857142857142855,0.6428571428571429,0.6666666666666666,0.6333333333333333,0.11527350892295431,4,0.94,0.9019607843137255,0.8545454545454545,0.9038461538461539,0.9056603773584906,0.9012025540127648,0.027238070666201757,4,0.6470588235294118,0.5625,0.5,0.6,0.7142857142857143,0.6047689075630253,0.07289484887842879,4,0.94,0.9019607843137255,0.8545454545454545,0.9038461538461539,0.9056603773584906,0.9012025540127648,0.027238070666201757,4,5,dfcmpltPreLC3_SITE3_Full,Full,dfcmpltPreLC3_SITE3,2024-05-03 23:11:23.856868
0.0091541767120361,0.000823287456584,0.0127125263214111,0.0028012485955961,RandomForestClassifier(),3.0,10.0,42.0,,,"{'clf': RandomForestClassifier(), 'clf__max_depth': 3, 'clf__n_estimators': 10, 'clf__random_state': 42}",0.7910447761194029,0.8059701492537313,0.8208955223880597,0.7761194029850746,0.835820895522388,0.8059701492537312,0.0211076651100461,5,0.6314016172506739,0.6145552560646901,0.6502695417789758,0.5431266846361186,0.657051282051282,0.619280876356348,0.0408793485627284,5,0.9056603773584908,0.9258760107816713,0.8908355795148248,0.8807277628032345,0.9301282051282052,0.9066455871172852,0.0192036618320112,5,0.8727272727272727,0.8849557522123894,0.8928571428571429,0.8695652173913043,0.9026548672566372,0.8845520504889492,0.0123392061710624,5,0.9056603773584906,0.9433962264150944,0.9433962264150944,0.9433962264150944,0.9807692307692308,0.943323657474601,0.0237516712137123,1,0.9056603773584906,0.9433962264150944,0.9433962264150944,0.9433962264150944,0.9807692307692308,0.943323657474601,0.0237516712137123,1,0.3571428571428571,0.2857142857142857,0.3571428571428571,0.1428571428571428,0.3333333333333333,0.2952380952380952,0.0805311167870845,5,0.8421052631578947,0.8333333333333334,0.847457627118644,0.8064516129032258,0.8360655737704918,0.8330826820567181,0.0141860518013812,5,0.5,0.5714285714285714,0.625,0.4,0.8333333333333334,0.585952380952381,0.1448441182585758,5,0.8421052631578947,0.8333333333333334,0.847457627118644,0.8064516129032258,0.8360655737704918,0.8330826820567181,0.0141860518013812,5,5,dfcmpltPreLC3_SITE3_Full,Full,dfcmpltPreLC3_SITE3,2024-05-03 23:07:50.802343
0.0262701988220214,0.0064990964249732,0.012343692779541,0.0025669909224682,LogisticRegression(),,,,1000.0,,"{'clf': RandomForestClassifier(), 'clf__max_depth': 3, 'clf__n_estimators': 10, 'clf__random_state': 42}",0.8955223880597015,0.8955223880597015,0.8507462686567164,0.8955223880597015,0.8955223880597015,0.8865671641791044,0.017910447761194,1,0.8814016172506738,0.8025606469002695,0.7742587601078168,0.8288409703504043,0.8378205128205127,0.8249765014859355,0.0358844151774409,2,0.9407008086253368,0.9555256064690028,0.9245283018867924,0.944743935309973,0.9596153846153844,0.945022807381298,0.0123453173094293,1,0.9320388349514565,0.9357798165137616,0.9056603773584906,0.9345794392523364,0.9333333333333332,0.9282783602818756,0.0113775438087923,1,0.9056603773584906,0.9622641509433962,0.9056603773584906,0.9433962264150944,0.9423076923076924,0.9318577648766329,0.0225365996422772,2,0.9056603773584906,0.9622641509433962,0.9056603773584906,0.9433962264150944,0.9423076923076924,0.9318577648766329,0.0225365996422772,2,0.8571428571428571,0.6428571428571429,0.6428571428571429,0.7142857142857143,0.7333333333333333,0.7180952380952381,0.0786161488894816,2,0.96,0.9107142857142856,0.9056603773584906,0.925925925925926,0.9245283018867924,0.925365778177099,0.0189921747365863,2,0.7058823529411765,0.8181818181818182,0.6428571428571429,0.7692307692307693,0.7857142857142857,0.7443732737850385,0.0625487832001841,1,0.96,0.9107142857142856,0.9056603773584906,0.925925925925926,0.9245283018867924,0.925365778177099,0.0189921747365863,2,5,dfcmpltPreLC3_SITE3_Full,Full,dfcmpltPreLC3_SITE3,2024-05-03 23:07:50.802343
0.0285123348236083,0.008274643770365,0.0321988105773925,0.0085263345681638,"XGBClassifier(base_score=None, booster=None, callbacks=None,
              colsample_bylevel=None, colsample_bynode=None,
              colsample_bytree=None, device='cpu', early_stopping_rounds=None,
              enable_categorical=False, eval_metric=None, feature_types=None,
              gamma=None, grow_policy=None, importance_type=None,
              interaction_constraints=None, learning_rate=None, max_bin=None,
              max_cat_threshold=None, max_cat_to_onehot=None,
              max_delta_step=None, max_depth=None, max_leaves=None,
              min_child_weight=None, missing=nan, monotone_constraints=None,
              multi_strategy=None, n_estimators=None, n_jobs=None,
              num_parallel_tree=None, random_state=None, ...)",3.0,10.0,42.0,,0.1,"{'clf': RandomForestClassifier(), 'clf__max_depth': 3, 'clf__n_estimators': 10, 'clf__random_state': 42}",0.9104477611940298,0.835820895522388,0.8208955223880597,0.8955223880597015,0.7910447761194029,0.8507462686567164,0.0452708981734421,3,0.9171159029649596,0.7648247978436657,0.8342318059299192,0.9076819407008088,0.5807692307692308,0.8009247356417168,0.123108489521911,3,0.942722371967655,0.9319407008086252,0.8962264150943398,0.9474393530997304,0.9474358974358974,0.9331529476812496,0.0193117387410897,2,0.9411764705882352,0.8952380952380953,0.8775510204081632,0.9306930693069309,0.8771929824561403,0.904370327599513,0.0267912668154031,3,0.9056603773584906,0.8867924528301887,0.8113207547169812,0.8867924528301887,0.9615384615384616,0.8904208998548621,0.0481105258147522,3,0.9056603773584906,0.8867924528301887,0.8113207547169812,0.8867924528301887,0.9615384615384616,0.8904208998548621,0.0481105258147522,3,0.9285714285714286,0.6428571428571429,0.8571428571428571,0.9285714285714286,0.2,0.7114285714285715,0.2763316552142902,3,0.979591836734694,0.903846153846154,0.9555555555555556,0.9791666666666666,0.8064516129032258,0.9249223651412593,0.0653438804260118,3,0.7222222222222222,0.6,0.5454545454545454,0.6842105263157895,0.6,0.6303774587985115,0.0638606936129173,3,0.979591836734694,0.903846153846154,0.9555555555555556,0.9791666666666666,0.8064516129032258,0.9249223651412593,0.0653438804260118,3,5,dfcmpltPreLC3_SITE3_Full,Full,dfcmpltPreLC3_SITE3,2024-05-03 23:07:50.802343
0.03216552734375,0.0061050309427317,0.0382274150848388,0.009436447078824,"XGBClassifier(base_score=None, booster=None, callbacks=None,
              colsample_bylevel=None, colsample_bynode=None,
              colsample_bytree=None, device='cpu', early_stopping_rounds=None,
              enable_categorical=False, eval_metric=None, feature_types=None,
              gamma=None, grow_policy=None, importance_type=None,
              interaction_constraints=None, learning_rate=None, max_bin=None,
              max_cat_threshold=None, max_cat_to_onehot=None,
              max_delta_step=None, max_depth=None, max_leaves=None,
              min_child_weight=None, missing=nan, monotone_constraints=None,
              multi_strategy=None, n_estimators=None, n_jobs=None,
              num_parallel_tree=None, random_state=None, ...)",3.0,10.0,42.0,,0.2,"{'clf': RandomForestClassifier(), 'clf__max_depth': 3, 'clf__n_estimators': 10, 'clf__random_state': 42}",0.9253731343283582,0.8507462686567164,0.8208955223880597,0.8955223880597015,0.9253731343283582,0.8835820895522388,0.0415772784393555,2,0.9528301886792452,0.8530997304582211,0.8342318059299192,0.9076819407008088,0.9282051282051282,0.8952097587946645,0.04484624596594,1,0.9454177897574124,0.940700808625337,0.8706199460916442,0.9305929919137466,0.9487179487179488,0.9272098970212176,0.0289482165905106,3,0.9504950495049505,0.9,0.8775510204081632,0.9306930693069309,0.9504950495049505,0.9218468377449988,0.0288412885978695,2,0.9056603773584906,0.8490566037735849,0.8113207547169812,0.8867924528301887,0.9230769230769232,0.8751814223512338,0.0402950436984244,5,0.9056603773584906,0.8490566037735849,0.8113207547169812,0.8867924528301887,0.9230769230769232,0.8751814223512338,0.0402950436984244,5,1.0,0.8571428571428571,0.8571428571428571,0.9285714285714286,0.9333333333333332,0.9152380952380954,0.0537399465892033,1,1.0,0.9574468085106383,0.9555555555555556,0.9791666666666666,0.979591836734694,0.974352173493511,0.0164167513900401,1,0.7368421052631579,0.6,0.5454545454545454,0.6842105263157895,0.7777777777777778,0.6688569909622541,0.0856631698882675,2,1.0,0.9574468085106383,0.9555555555555556,0.9791666666666666,0.979591836734694,0.974352173493511,0.0164167513900401,1,5,dfcmpltPreLC3_SITE3_Full,Full,dfcmpltPreLC3_SITE3,2024-05-03 23:07:50.802343
